5 5 2
############
#..........#
#.###..###.#
#.#......#.#
#...##@....#
#....o##...#
#.#......#.#
#.###..#.#.#
#..........#
############

############
#xxxxxxxxxx#
#x###xx###x#
#x#xxxxxx#x#
#xxx##oxxxx#
#xxxxx##xxx#
#x#xxxxxx#x#
#x###xx#x#x#
#xxxxxxxxxx#
############