1 1 0
############
#o###......#
#..##.###..#
#..##...#..#
#.#####.#..#
#...###.#.##
###.#...#.##
#...#...#.##
#.....###.@#
############

############
#x###xxxxxx#
#xx##x###xx#
#xx##xxx#xx#
#x#####x#xx#
#xxx###x#x##
###x#xxx#x##
#xxx#xxx#x##
#xxxxx###xo#
############