1 8 6
############
#..........#
#.###..###.#
#.###..###.#
#.###..###.#
#..........#
#.###..###.#
#.###..###.#
#o###..###@#
############

############
#xxxxxxxxxx#
#x###xx###x#
#x###xx###x#
#x###xx###x#
#xxxxxxxxxx#
#x###xx###x#
#x###xx###x#
#x###xx###o#
############