1 1 0
############
#o##.......#
#.#....#...#
#.#.....#..#
#.#..##.#.##
#.#..#....##
#.#@.#.#...#
#....#.....#
#....#..#..#
############

############
#x##xxxxxxx#
#x#xxxx#xxx#
#x#xxxxx#xx#
#x#xx##x#x##
#x#xx#xxxx##
#x#ox#x#xxx#
#xxxx#xxxxx#
#xxxx#xx#xx#
############