6 4 0
############
#..........#
#.#......#.#
#.#......#.#
#.#...o..#.#
#.#......#.#
#.#......#.#
#.#........#
#@##########
############

############
#xxxxxxxxxx#
#x#xxxxxx#x#
#x#xxxxxx#x#
#x#xxxxxx#x#
#x#xxxxxx#x#
#x#xxxxxx#x#
#x#xxxxxxxx#
#o##########
############
