1 1 4
############
#o.........#
#.@.....##.#
#.#.#.#.##.#
#.###......#
#.........##
#.###..##..#
#..........#
#......##.##
############

############
#xxxxxxxxxx#
#xoxxxxx##x#
#x#x#x#x##x#
#x###xxxxxx#
#xxxxxxxxx##
#x###xx##xx#
#xxxxxxxxxx#
#xxxxxx##x##
############