1 1 3
############
#o...#.....#
#..#.#.###.#
#....#.###.#
##.###.##@.#
#..........#
#.##.#.###.#
#.##.#.###.#
#....#.....#
############

############
#xxxx#xxxxx#
#xx#x#x###x#
#xxxx#x###x#
##x###x##ox#
#xxxxxxxxxx#
#x##x#x###x#
#x##x#x###x#
#xxxx#xxxxx#
############