1 8 3
############
#..........#
#.#......#.#
#.#.####.#.#
#...##.....#
#......#...#
#.#.####.#.#
#@#......#.#
#o.........#
############

############
#xxxxxxxxxx#
#x#xxxxxx#x#
#x#x####x#x#
#xxx##xxxxx#
#xxxxxx#xxx#
#x#x####x#x#
#o#xxxxxx#x#
#xxxxxxxxxx#
############