1 1 0
############
#o.........#
#@###..###.#
#.###..###.#
#..........#
#..........#
#.###..###.#
#.###..###.#
#..........#
############

############
#xxxxxxxxxx#
#o###xx###x#
#x###xx###x#
#xxxxxxxxxx#
#xxxxxxxxxx#
#x###xx###x#
#x###xx###x#
#xxxxxxxxxx#
############