10 1 0
############
#.........o#
#........###
#..######..#
#..######..#
#..@...#...#
#..###.#...#
#..###.....#
#..........#
############

############
#xxxxxxxxxx#
#xxxxxxxx###
#xx######xx#
#xx######xx#
#xxoxxx#xxx#
#xx###x#xxx#
#xx###xxxxx#
#xxxxxxxxxx#
############